EEEEEEEEEEEEEEEEEEEEEEEEEEEEEEEEEEEEEEEE
EEEEEEEEEEEEEEEEEEEEEEEEEEEEEEEEEEEEEEEE
EEEEEEEEEEEEEEEEEEEEEEEEEEEEEEEEEEEEEEEE
EEEEEEEEEEEEEEEEEEEEEEEEEEEEEEEEEEEEEEEE
EEEEEEEEEEEEEEEEEEEEEEEEEEEEEEEEEEEEEEEE
EEEEEEEEEEEEEEEEEEEEEEEEEEEEEEEEEEEEEEEE
EEEEEEEEEEEEEEEEEEEEEEEEEEEEEEEEEEEEEEEE
EEEEEEEEEEEEEEEEEEEEEEEEEEEEEEEEEEEEEEEE
EEEEEEEEEEEEEEEEEEEEEEEEEEEEEEEEEEEEEEEE
EEEEEEEEEEEEEEEEEEEEEEEEEEEEEEEEEEEEEEEE
EEEEEEEEEEEEEEEEEGEEEEEEEEGGGEEEEEEEEEEE
EEEEEEEEEEEEEEEEEEEEEEEEEEGGGEEEEEEEEEEE
EEEEEEEEEEEEEEEEEEEEEEEEGGGGGEEEEEEEEEEE
EEEEEEEEEEEEEGGGGEEEEEGGEEEEEEEEEEEEEEEE
GGGGGGGGGGGGGGGGGGGGGGGGGGGGGGGGGGGGGGGG
