EEEEEEEEEEEEEEEEEEEEEEEEEEEEEEEEEEEEEEEE
EEEEEEEEEEEEEEEEEEEEEEEEEEEEEEEEEEEEEEEE
EEEEEEEEEEEEEEEEEEEEEEEEEEEEEEEEEEEEEEEE
EEEEEEEEEEEEEEEEEEEEEEEEEEEEEEEEEEEEEEEE
EEEEEEEEEEEEEEEEEEEEEEEEEEEEEEEEEEEEEEEE
EEEEEEEEEEEEEEEEEEEEEEEEEEEEEEEEEEEEEEEE
EEEEEEEEEEEEEEEEEEEEEEEEEEEEEEEEEEEEEEEE
EEEEEEEEEEEEEEEEEEEEEEEEEEEEEEEEEEEEEEEE
EEEEEEEEEEEEEEEEEEEEEEEEEEEEEEEEEEEEEEEE
EEEEEEEEEEEEEEEEEEEEEEEEEEEEEEEEEEEEEEEE
EEEEEEEEEEEEEEEEEGEEEEEEEEGGGEEEEEEEEEEE
EEEEEEEEEEEEEEEEEEEEEEEEEEGGGEEEEEEEEEEE
EEEEEEEEEEEEEEEEEEEEEEEEEEGGGEEEEEEEEEEE
EEEEEEEEEEEEEGGGGEEEEEEEEEEEEEEEEEEEEEEE
GGGGGGGGGGGGGGGGGGGGGGGGGGGGGGGGGGGGGGGG
